2222222222222222222222222222222222
2000000000000003332000000000000202
2022222222222223332222202222200202
2000200202000022222020200020202202
2220000000020000000000202000200002
2020222222222022202020222222202202
2022200000002000202220000020000002
2000002222202220200020202020222222
2022222000200022222020202220000022
2000002020222020002220202022202022
2022202020202022000000222000202022
2000202020000002022000000020002002
2202202022222222002222200022202202
2000000000020002202000222000202002
2202222022220200002220002222222022
2000002000000202200020200000000002
2222202222220202222000222222222202
2000002000000200020020000002000202
2002200022222222020220222022020202
2202202020000000000020200020020002
2202222022202222202002020222220222
2202000020002002002022002000020002
2202002220202020202002202222022002
2002022000200020202202002000002202
2022022020002020202202022220200202
2022022022222020200002020000220202
2000002000002020220202022020020002
2222002222002000000200002000022222
2222002222002220000222002222002222
2000000000000000000000000000000002
2000000000000000000000000000000002
2000000000000005555000000000000002
2000000000000005555000000000000002
2000000000000005555000000000000002
2222222222222222222222222222222222



