22222222222222222222222222222222222222
20000000000000000000000000000000000202
20000000000000000000000000000000000202
20000000000000000000000000000000000202
22222220222222220020000000000000000202
20020000200000000022222222222222220202
20000200002000233320000000000002020202
20222222222222233322222022222002020002
20002002020000222220202000202022022202
22200000000200000000002020002000000202
20202222222220222020202222222022022202
20222000000020002022200000200020000202
20000022222022202000202020202222223202
20222220002000222220202022200000223202
20000020202220200022202020222020223202
20222020202020220000002220002020223202
20002020200000020220000000200020023302
22022020222222220022222000222022022222
20000000000200022020002220002020020002
22022220222202000022200022222220222222
20000020000002022000202000000000000002
22222022222202022220002222222222022202
20000020000002000200200000020002000002
20022000222222220202202220220202020222
22022020200000000000202000200200020202
22022220202220222220200220222202220202
22020000200020020020220020000200020202
22020022200020202020022022220220020202
20020220002000202022020020000022020202
20220220200020202022020222202002020002
20220220222220202000020200002202022202
20000020000020202202020220200200000202
22220022220020000002000020000222220202
22220022220022200002220022220022220202
20000000000000000000000000000000020202
20000000000000000000000000000000020202
20000000000000055550000000000000020002
20000000000000055550000000000000020202
20000000000000055550000000000000020202
22222222222222222222222222222222222222









































